1111002001111
1012221222101
1000001000001
1000001000001
1000010100001
1001000001001
1012222222101
1111000001111
