0100000000010
0010000000100
0011111111100
0112211122110
1011111111101
1010000000101
1001100011001
0000000000000
