1111111111111
1100000000011
1122222222211
1100000000011
1100000000011
1122222222211
1100000000011
1111111111111
