0000000000000
0111111111110
0122222222210
0010000000100
0010000000100
0010000000100
0122222222210
0011100011100
