1111111111111
1111011101111
1110001000111
1110000000111
1110000000111
1111000001111
1111100011111
1111110111111
