1111111111111
1000011100001
1000011100001
1101100011011
1000022200001
1111122211111
1111100011111
2222000002222
