2222222222222
2111111111112
2100000000012
2101111111012
2101002001012
2101111111012
2100000000012
2222200022222
