1112222222111
1122020002211
1222020222221
1222000002221
1222220202221
1222000202221
1122222222211
1112222222111
