1111111111111
1000100010001
1121122211211
1000000000001
1000000000001
1121112111211
1000100010001
1111111111111
